25 25
!#######################!
!#          #          #!
!# ## ##### # ##### ## #!
!#                     #!
!# ## # ######### # ## #!
!#    #     #     #    #!
!#### ##### # ##### ####!
!!!!# #           # #!!!!
##### # # ##### # # #####
#       # #   # #       #
##### # # ##### # # #####
!!!!# #           # #!!!!
!#### # ######### # ####!
!#          #          #!
!# ## ##### # ##### ## #!
!#  #               #  #!
!## # # ######### # #  #!
!#    #     #     #    #!
!# ####### ### ####### #!
!# #     #     #     # #!
!# # ### ## # ## ### # #!
!# # #      #      # # #!
!# # # #### # #### # # #!
!#          #          #!
!#######################!